ththtttttththhhthhhtthhhtthhhhthhhhhhtttttttthttthhhhthhhhtt
t    cccccccccccccccbbbbbbbbbbbbbbbbbbbbbbcccccccccccccc   t                                             
t o      p  n      l        m         e     p   e     m  o t
t o e           e      p       c     p       l    n      o t
t   p     m        p       m     e     e         e    p  o t
t o     c   n     n     n     e          j    p    l     o t
t   m    e      l  e   m       p  p   m      n      m   o  t
t          p     p    p   n   n         p       m        o t
t   m  n     e           m        l      e    l      n  oo t
t           l       p e       j      m           m     ooo t
t ooe   e       p       lllll      e      l              o t
t   p      j  m    m      e        j            c      e o t
t     m          p      p p    n    n    l               o t
t o       l    r   n                       m     j  p  p   t
t     m         p    r     m   e     p    m                t
t  m      n j       l             n        n  m    l l   p t
t     n        r  n    j    e  e      o           b        t
t        m e  p        p            ttt    s m    pp    n  t
t     p       m   n  c   e      n      ttt z  c       n    t
t  m    n  e     e       n           n               p     t
t oo       m    c     m     p      l       m     m    l  l t
t    p        j        n     e         m        j   n      t
t     n     j      n  m         e    n   p             n   t
t o  m      p     m      noo   p            j    m    l  l t
t    p       n       e    oto   p    l    o         n      t
t    j     c     l     c  otto          c o   c   m     c  t
t o   l   e      e   p   ottttto   n   n        e   m    l t
t    p     e  n e   m    ottttttto  e   m l   e   m    e   t
t  c ccccccccccccccccccbbtttttttttcccccccccccccccccccccbb  t
tttttttttttttttttttttttttttttttttttttttttttttttttttttttttttt